þþþþþþþþþþþþþþþþþþþþþþþþ
þษอปþษออปþษอออออออออออปþ
þบþบþบþþบþบþþþþþþþþþþþบþ
þบþบþบþþบþบþþþþþþþþþþþบþ
þบþบþบþþบþบþþþþþþþþþþþบþ
þบþบþบþþบþบþษอออปþþþþþบþ
þบþศอผþþบþบþบþþþบþþþþþบþ
þบþþþþþþศอผþศอปþบþษอออผþ
þศอออปþþþþþþþþบþบþบþþþþþ
þþþþþบþþษอปþþþบþบþศอออปþ
þษอปþบþþบþบþþþบþบþþþþþบþ
þบþบþบþþบþบþþþบþศอออปþบþ
þบþบþบþþบþบþþþบþþþþþบþบþ
þบþศอผþþบþบþþþบþษอออผþบþ
þบþþþþþþบþบþþþบþบþþþþþบþ
þศออออออผþศอออผþศอออออผþ
þþþþþþþþþþþþþþþþþþþþþþþþ