111111111111111111111111
102220020001500000000001
101010110101000000400001
101010100101000000000001
101012020101111111011111
101010100100000000000001
101010110001111111101111
100012012221222100020001
100020020001222101121101
101010110201222101121101
101010110101222101020101
101012000101112201111101
101010100100000120000001
101010110001110111111101
101012012221110122222101
100012012220000121212201
111111111111111111111111